10 10
1 1 1 1 2 2 1 1 1 1
4 3 3 3 2 2 1 1 1 1 
1 1 1 1 1 1 1 1 1 1
2 2 2 2 2 2 2 2 2 2 
2 2 2 2 3 3 4 4 4 5
1 1 5 1 1 1 1 1 1 1
1 1 1 1 1 1 1 2 3 4
1 1 1 1 1 1 1 1 1 1
2 5 5 2 2 2 2 2 2 5
2 2 5 5 2 5 2 5 2 5